..###########################################################
..................#.#...#.....#.....#...#.....#.......#...#.#
#.#.###.#.#######.#.###.###.#.#.#.###.#.#####.#.#######.###.#
#.#.#...#.......#...#.#.....#.#.#.#.#.#.......#.#.#.#...#...#
#.#.###.#.#.#######.#.#.#.#.#.#.###.#.#####.###.#.#.#.#####.#
#.#.#...#.#...#.........#.#.#.......#.#.#.#.................#
###.###.#########.#.#.#####.#########.#.#.#.#.#############.#
#.....#...#.......#.#.....#.........#.#.....#.....#...#.....#
#########.###########.###.###.#####.#.###.#####.#.###.#####.#
#.#.....#.#...#.#.#.....#.#...#.#.#.#...#.#.....#...#.....#.#
#.#.#######.###.#.#.#####.#.###.#.###.###.#.#.###.###.###.#.#
#...#.......#...#...#...#.#.#.#...#...#.#.#.#.#.#.#.#...#.#.#
#.#####.#.###.#.###.#.###.###.#.#######.#####.#.#.#.###.###.#
#.#.#.#.#.#...#...#...#.#.#.#.......#...#.#.#.#.#...#.#...#.#
#.#.#.###.###.#####.###.###.#######.#.###.#.#.#.###.#.#.###.#
#.#.#.#.....#...#.......#.#.#.#.....#.#...........#...#.#...#
#.#.#.#.###.###.#.#.#.###.#.#.###.###.#####.###.#####.#.###.#
#.#...#...#.#.#...#.#...#...............#.#...#...#...#.#.#.#
#.#.#####.###.#####.###.###.###.###.###.#.#######.###.#.#.#.#
#.......#...#...#.....#.......#...#...#.#.#.......#.......#.#
#.#.###.#.#.#.#.#.#####.#.#####.#.#.###.#.###.###.#########.#
#.#.#.....#.#.#...#.#...#.#...#.#.#...#.........#.#.....#...#
#.#.#####.#########.#.#######.#####.#####.#####.#.#####.###.#
#.#.#.#.#...#...#.#.......#...........#.#.....#.#...#.......#
#.#.#.#.#.#.###.#.#.#######.###########.###.#.###.#.#########
#.#.#.....#.#...#.#...#.#.....#...#.#.....#.#.#...#...#.#...#
#.#.###.###.#.###.#.###.#.###.###.#.###.#########.#####.###.#
#.#.#...#...#...#.....#.....#.#...#...#.....#.....#.#.#.....#
#####.#.#######.#####.#######.#.#####.#####.#.#####.#.#.#.#.#
#.....#.#.........#...#.#...#.....#...#.......#.....#...#.#.#
#####.#######.#####.#.#.#.#.###.#.###.#.#.###.###.###.#####.#
#.....#...#.#...#...#.#...#...#.#.#.#.#.#.#...#...#...#.....#
#.#######.#.#.#.#####.#.#.###.###.#.#.###########.###.#####.#
#.......#.#...#.....#.#.#.#.#.#.......#.#...#.....#...#.#...#
#.#####.#.###.#####.#.#####.#.#####.###.###.#.###.###.#.###.#
#.#.......#.....#...#...........#.#...#.....#.#.#.....#.....#
#.###.#####.#######.###########.#.###.#.###.#.#.#############
#.#.....#.#.......#.#.........#...#.#...#...#.......#.#.#...#
#.#.###.#.#.#.###.#.#####.###.#.###.#.#.#######.#.###.#.###.#
#.#...#.#.#.#.#.#.#.#.#...#.......#...#.#...#...#...#...#...#
#.#.###.#.###.#.###.#.#####.#.#.#.#######.#######.#####.#.#.#
#.#.#.#...#.....#.#.....#...#.#.#.......#...........#.....#.#
#####.#.#######.#.###.#.###.#######.#########.###########.###
#...#.#...#.......#...#.#.....#...#...#.#.....#.#...#.......#
#.###.#.#####.#.#######.###.#####.#.###.#.###.#.###.###.###.#
#.#.#.#.#.....#.#.................#...#.#.#.....#.....#.#...#
#.#.#.#.#.###############.###########.#.#.#######.#######.#.#
#...#...#.#.....#.#.......#...#.........#.....#...#.......#.#
#.###.###.#.#####.#.#.###.#.###.#.###.#######.###.###.#.#.###
#...#.#.#.......#...#.#.....#.#.#.#.#.#.#.#.........#.#.#...#
#.###.#.#.###.#.#.#######.#.#.#####.#.#.#.###.###.###.###.#.#
#...#.#...#...#.#.#.......#...#.#...#.#.......#...#...#.#.#.#
###.#.###.#.#####.#.#.#####.#.#.###.###.#.#.###.###.###.###.#
#...#.#...#...#.#.#.#.#...#.#.#...#.....#.#.#...#.....#.....#
#.#.#.###.#####.#.#.###.#.#.#####.#.#.###.###.###########.###
#.#...#.#.#.......#.....#.#.........#.#.....#.#.#...........#
#.###.#.#######.#.#########.###.#########.#.#.#.#.#.#.#.#####
#.#.......#.....#.......#...#.#.......#...#.#.#.#.#.#.#.....#
#.#.#.###.###########.#####.#.#.###.###.###.#.#.###.#########
#.#.#...#.................#...#.#...#...#...#................
###########################################################..