..#############################
............#.......#.#.#...#.#
#.###.###.###.###.###.#.#.###.#
#...#...#.....#.............#.#
#.#.#.#####.#.###.###.#####.#.#
#.#.#...#.#.#.#.#...#.#.#.#...#
#.###.#.#.#.#.#.#.#####.#.###.#
#.#...#...#.#.#.....#.....#...#
#.#.###############.#.#.###.###
#.#.#.....#...#.....#.#.#.#...#
###.#####.###.#####.###.#.#####
#...#.#.......#...#.#.....#...#
#.#.#.#######.###.#.#.#.###.###
#.#.#.........#.#.#...#.......#
###.#####.###.#.#.#########.###
#.#...#.#.#...#.........#.....#
#.#.###.#.###.#####.#.#.###.#.#
#...#.......#.....#.#.#.#...#.#
#.###.###.#########.#.#.#######
#.#...#.......#.....#.#.#.....#
#.#.#.#.#.#.#.#.#########.#.###
#...#.#.#.#.#.....#.#.....#...#
#.###.#.#.###.#.###.###.###.###
#...#.#.#.#.#.#.......#.#.#...#
###.###.###.#.#.#.#.#.###.###.#
#.....#.....#.#.#.#.#...#.#...#
#.#.###.###.#######.###.#.#.###
#.#.#.....#.#.#.......#.#.....#
#.#########.#.###.###.#.#.#.###
#.....#.........#.#...#...#....
#############################..
