..#########
......#...#
#####.#.###
#.........#
#.#######.#
#...#.#.#.#
#.###.#.#.#
#.....#.#.#
###.###.#.#
#...#......
#########..
